    #  ###  # # #   ###### # #
### #  #    # # ##  ##   #    
##   #   ###    # #  # ##  ## 
 ##  #### #   # #  ## #   # ##
    #   ### # ##          ##  
#  ####  ## #   #  #  #####  #
##      #  ###   #  #  #### # 
##### #  #          # ## #    
## ###  #  ###      #     # ##
         # # # ###  #    ## ##
 #   #           ### ##   # ##
   ### # ## #     ##  # ###   
# #### ### ### ## #  # #### ##
  #      # #  #   # #    #####
  ###  # ###  ## ## # # ##   #
#   ## # ###  #       # ## #  
##  ####     ###  ##   ## ### 
  # #     #### ##  ##   # ### 
 #  ##       #  # ## ##   ##  
    #  # ## ##      ####       