##############################
##   #########################
### ##########################
### ##########################
### ##########################
###                           
###  ######################## 
###  ######################## 
###  ######################## 
###  #########################
###  #######################  
###  ######################  #
###  ###################    ##
### #################### #####
### #################### #####
###   ################## #####
##### ################## #####
##### ######             #####
#####        ###########      
##############################